StartRoom
9
9
#########
#FFFFFFF#
#FFFFFFF#
#FGFFFFF#
#FGFFFFFR
#FFFFFFF#
#FFSFFFF#
#FFFFFFF#
#########