StartRoom
9
9
#########
#FFFFFFW#
#FFFFFFF#
#FGFFFFF#
#FGFFFFFR
#FFQQQFF#
#FFFFFFF#
#FFQFQFF#
#########