StartRoom
9
9
#########
#FFFFFFW#
#FFFFFFF#
#FGFFFFF#
#FGFFFFFR
#FFFFFFF#
#FFFFFFF#
#FFFFFFF#
#########