StartRoom
9
9
#########
#FFGFFFW#
#FFSFFFF#
#FFFFTFF#
#FFTFFFFR
#FFQQQFF#
#FFFFFFF#
#FFQFQFF#
#########