StartRoom
9
9
#########
#FFGFFFW#
#FFSFFFF#
#FFFFFFF#
#FFTFFFFR
#FFFFFFF#
#FFFFFFF#
#FFFFFFF#
#########