DungeonRoom
9
9
WWWWDWWWW
WFFFFFFFW
WFFFFFFFW
WFFFFFFFW
DFFFFFFFD
WFFFFFFFW
WFFFFFFFW
WFFFFFFFW
WWWWDWWWW