9
9
WWWWWWWWW
WFFFFFFFW
WFFFFFFFW
WFFWWWFFW
LFFWWWFFR
WFFWWWFFW
WFFFFFFFW
WFFFFFFFW
WWWWWWWWW