9
9
#########
#FFFFFFF#
#FFFFFFF#
#FF###FF#
LFF###FFR
#FF###FF#
#FFFFFFF#
#FFFFFFF#
#########