12
12
############
#FFF#FFFWWW#
#FFF#FFFWWW#
#FFF#FFFWWW#
LFFF#FFFFFFR
#FFF##FFFFF#
#FFFFFFFFFF#
#FFFFFFFFFF#
#FFFFFFFFFF#
#FFFFFFFFFF#
#FFFFFFFFFF#
############