9
9
WWWWWWWWW
WFFFWFFFW
WFFFWFFFW
WFFFWFFFW
LFFFWFFFR
WFFFWWFFW
WFFFFFFFW
WFFFFFFFW
WWWWWWWWW