9
9
WWWWWWWWW
WFFFFFFFW
WFFFFFFFW
WFFFFFFFW
WFFFFFFFR
WFFFFFFFW
WFFFFFFFW
WFFFFFFFW
WWWWWWWWW