NormalRoom
12
12
############
#FFF#FFFWWW#
#FFF#FFFWWW#
#FSF#FFFWWW#
LFFF#FFFFFFR
#FFF##FFFFF#
#FFFGGGFFFF#
#FGGGGGGFFF#
#FFGGFFFFFF#
#FFGFFFFFFF#
#FFFFFFFFFF#
############